1111111111111
10010000000C1
1100011111111
1P01000000E01
1111111111111