1111111111111
100000010C011
1110011110111
1000000000001
1000000000001
1000000000001
100000P000001
1000000000001
1000000000001
1011000010E11
1111111111111