11111111111111111
1CP00000110000001
10000010000000001
100001E1000011101
10000010000011101
10000000000000101
11111111111111111