11111111111111111
1CP00000110000001
10000000000000001
100000E0000011101
100000000000111011
10000000000000101
11111111111111111