1111111111111
100100010C011
1110011111111
1011P00010E11
1111111111111