11111111111111111111111111111
10000P00000E01100000000000001
10111101110001101111011111101
10100001000000000000010000101
10101111011110011111011101101
1000100000000000C000000000001
11111111111111111111111111111