111111111111111111111111111111
10P01110000000000000000000E001
1000000000111111100C000C000001
10011100000001100001100C000001
10000011111000C00111000C000001
100001110000001111110000001101
1000C00C0000110000011111111101
10000000011111111100000C000101
10000C000000000000000000000101
111111111111111111111111111111