11111111111111111111111111111
1P0000C00001111111000000000E1
10111100011111110111111111101
10000000001000000000C00000001
10111011110111111110111111101
10001000000000100001000000101
11111111011111110111110111101
10000000000000000000010000011
1011111100000C000001111111101
10000000000001000000010000001
10111111110000000001111111101
10000000001000000000000000001
10111011111111011110111111101
10001000000000010000000000101
11111111111111111111111111111